11111111111111111111
10100010000010000001
10101010101010000001
10101010101010000001
10101010101010000001
10101010101010000001
101010101P1010000001
10101010101010000001
101010101C1010000001
101010101X1010000001
10101010111010000001
10101010010010000001
10101011000110000001
10101001101100000001
10101100001000000001
10101111111000000001
10101000000000000001
10101110111000000001
101000001E0000000001
11111111111111111111
