1111111111
10000E0001
1C00100001
1000C00001
100C100P01
100C000011
1000000001
1100000001
1101C00001
1000C00001
1000000101
1010001001
1000000101
100010C001
10000CC001
100C000001
1000C00001
100001C011
10010000X1
1111111111
