1111111111111111111111111111111111111111
1P10000000000000000000000000000000000001
1010000000000000000000000000000000000001
1010000000000000000000000000000000000001
1010000000000000000000000000000000000001
1010000111111111111111111111111111111101
1010000100000000000000000000011111000001
1010000100000000000000000000000000000001
1010000100000000000000000000000000000001
1010000100000000000000000000000000000001
1010000100000000000000000000000000000001
1C1E000100000000000000000000000000000001
1011111100000000000000000000000000000001
1000011100000000000000000000000000000001
1111011100000000000000000000000000000001
1000011100000000000000000000000000000001
1000011100000000000000000000000000000001
1000000000000000000000000000000000000001
1000000000000000000000000000000000000001
1111111111111111111111111111111111111101
1000000000000000000000000000000000000001
1011111111111111111111111111111111111111
1000000000000000000000000000000000000001
1111111111111111111111111111111111111101
1X00000000000000000000000000000000000001
1111111111111111111111111111111111111111
