11111111111111111111111111111111111111111111111111111111111111111111111111111111111111111111111111111111111111111111111111111111111111111111111111111
10000000P0000C00E100000000000000C000000CC0C00000000C00010C010C100101C0000010C0C010000000000C00C00000000C0000010111C000100000C0000C0100CCC0C0000010001
1000100001000000C000000100100000C01000000000000000000100010C010001000000000001000C00C001C000000000000001C0000000000C000C00001000C000000C0100001000001
10C1000010000000000000CC00000000C00100000C0000010000000000000000000000000C0C00000011C010000000C000C0000000000000000000C010000000100000010000000CC0001
10C010C00000C00C00010000C0000C010000C000100000010000C000010C0000000C00000000C1000C00C00C000000110010C0000001000C00C00001C0001000001000C000000C0000001
10000C00000000000000000C010C0001001000001000C0000001C011000CC0000000010000C00000000000000C00000000000000001000000C0C010010000000C000C0CC0010000000C01
100000000C00000000C00000000000C00000000000001C000000000C0000000000010000C100C000CC0000000000000000C00100000C0001C000000001000000000001000000011000001
100001000C00C00C0100C0000000C000000C0010000C00000000000010000000000C1C0010C000C000010000000101000C000001000C0CC00000010000C0100C0C0100000000CC0000001
100000000000000000100001001000000001000C000000C0C00C0000000000C000100000000C000C000C00C0000000010C0000C100000C00000000CC000001000000100000000011000C1
10000000010000C000000100001C0C01C00000001CC0000001000CC000000C0010000000C0010C000C0C00000000001000C000001010000C00C000C010C0000C1000000010C0000000101
100C0000101C000000000000000100100C000010000000000C0000000C00010C1000C000000C0C000001000000000C00000000000000010001001000000010000000C00C000C000010C01
1C000000000000000CCC0010000C00100000C100000000000010001C0C000000000001C00010000C0C10000C0000000001C000000000000000000000000C01000000C100C100000000001
10000000010000C000000000010000001C000000000000000C01000000100010010C000000010C00000000000000000000000000000001000100010000010100C01000000001CC0011001
100000C010C00100C0000010000000C00C00000000000000000C00000000C0000000000000C00000011000CC0000010000000000C00000000000010000000000001100000000010000101
1CCC0000000000C11000000001C000000000C0C0010000100100100100C00101001C1000000C000000000000C01000100010000C0000C0001000000000C00010001C00000000C00010C11
10001000010000C0000000000000000001000010CC0100000C0000C00000000C100000000000000000000000C00000100000100C000000C10000000001000C00000000000C00000000001
1C00000010C0000000C001000C000000010000000000000100000000000010C000000010000010001001000000000000000000000C000000000001000000000000C000000001000000CC1
100000000C000000000010100000000000000000010000000000000001000000000C0C000000000000000000C0000010000000000C1C000000C0000000CC1C00000100000000100000001
10C0000010000000000000000000000000000C00C0C00010100001000001C00C000C0010100000000C0000000000000000000C000C10C000000C000000000000C00100000000000000C01
11000000000C000010000001000CC0000000000000000000CC0C000000000C1000100010C00C010000010C000CC000C000000000000000000000000000000000010000000C000000000C1
1000000000C1000C001C1001100CC000000000C000000C000000100000001000000000C00001000000000100001001100000C00010001C0000C000C00001000000000000C000000C00001
10000100010C0000C00001100000000000010000000001000100000C0100001000000000000000000CC0000000000C0C100000000C0000010000000101000011C0000C101000000000001
10000000C1000C0000100C000C101010000000010000000000000000000000C00000011C00000000000000000100001100000000000CC0100C010C1000001000000100000000000CC0C01
1000C0000C0001000C000000000000CC00001000100C100000100100000001C0001000101100010000000000000000C000C0000000001C0001C000000000100000000000000000C000001
1000000C0011C000000000001000001000000C0C10C0CC0000000000010000C001C00C000000000100CC0010000000000000000000C00000000000CC1000000100000000CC00000000001
100000CC00C0011000000000000000100C00000000000000000C000C000C00C0000010001C00000C0100000C0000000000C0000000C0010100100C0000000C00C00100000010000C00001
1001000000000000010000C00001000011010C000C00000C0010C00000011100C00C00C1C0010000000C0000CC0000C000000100100C01110000C000000000000000000100C0110000001
11000010000000100CC100000C0010000000C1000000000C00000000C00CCC00010C0000C000000C0000000000C00000100000000000000000000C01000000101000C0010000000000C01
10000000100C01C000000000000000100000011000000000100001001C00C00000C10000100010001CC00000000010C00000000000C00000010C0C00C001000000CC100111000000100C1
100100000000001001000C00000000000000000011010000010000C00C0000000011000000C00000000000000000000000010C0CC00C000100000C00000001100C00000C0000000C0C011
10000000100000000000000000C100000001000000000C0C00000CC000000000000000C000000000000010C000101000000000100C0000000000C000000000C00000000000C00C0000001
10000C0C0C000001000000001001000000000010000000000010000000000000000000CC00000C0010CC00000101000110CC10000CC001000000001000001001000000000001C00000001
1C0000000000C00C0000000000000000000010000C1000000C1000000C00000C000000001C000000000000000C000100C0000C10000C00C000100000C0C010000C00C0000000000000001
100000000000000C01CC000C00C00000000000000000C000000100C000000010001010000000000000000000100000001100000000000000C0C000100C01000001000000C0C0C00000C01
10C1000000010000001C0100CC01001000C0C0000100001000100000000C00000C000100010000C0000100000000010001000C001000000000000CCC00000C000C1100C00000000000001
1C00001000000000000010C000001C0000C000000C001010C00000010010000000000000C000000000000010000100000C1C00C000000000100C001000C000001000011000000000000C1
100CCC11000C000C100100C0000000000000010001000000000C000001001000C000000001000000000000C00C000001000CC000000100010100010C00000C1010C000000010C001C0011
1C000000100C0000C010000000000000000000000000000000C00100000C00000000011000000000010000000000C0001000000C0110000C00000C0000000000000000001C00C00000001
10000C00000000000000000010C1000100001000001000C0000000110000100C00000000000C0000C0000100C000000000C00C0000000C0000001100C000000000100000000000C000001
110000000010000000000100C00C00000000C00101C0000C000C010000000000100C00000C000C00000C0000000000000000C0C000000C000000100C000000000001100000001C00C0011
1000C00C001000000000000CCC000000000C00000000001CC000100000000000000000000000C0000C00C110CC000000100000000000001000000000000000100000001010000C0000C01
100C000100001000010000CC000000000010000C100000C0000000C000000C0000C01C0000000C0000000000C001000100000000CC00010C00C00C00001C010000C0000C0000010000001
10C0000C0CC0010C00001000011C00000010000000000C000000C0000000001000000000000000000C00100000001000000010C000100000000C00000001000000000C01000001000C001
100001010C00011C00100000000110C00001000C1001C00000010000100000000000100100000000000000C00000C00C00C01000C1000000000000000000000C0C0000000000000100001
10C00000000000000CC00000CC0000000C000000100000C000000000000010000000C0C0000000C100000000000000C0C0000000000000100000000C001000001000000000000C1000001
101000000CC000000000000100000000C0C0100000000010001000000010100000000C0000000000000001000C00C01CC000001C100000000010100000000000010100000000000000011
1C00000000100000C000001011100000000C000000000010010000100000100C0C0C000000100000C0001001000000000000000000000000000000000C0C1000100000000C00000001001
10C010000C0C00000100000000110101000000100011000000000C000001001000000000000001000000101000010100000000000000C1000000000101000C000001001C00C0C0C0000C1
101C00001C010C0100100000C10C0000C000100000000C000C000000C00000C000001000C0010000000000010000110000000000100C0000000100110000C00001C100000000000000101
10000101C0C00C001000000000000000000C000000000000C0000000C000000CC000C00C000000010010000010C10000000000C000010C0101000000000000000000000C0001010000001
1C00100C00101000C000000000100C0C0010000C01000000000C000000C000000C00000C1001CC00C00000CC0001000010000000000010000000000000000000000000C000000C00001C1
100C00C000000000C00C0000C10C0000000C0000000C00000CC001100000C00101C0010000C1C000100C000000000C00000000000000101C0100C0000000000001000CCCC000101CC0001
100000C001C00000000000000000000CC00000000000C000C00000C00000000000000100000000000000000000C0100000000000000000100000000100C00001000000000001000000001
11100000C00000000000C0C000C0000000C0000000000000C000C0000000C000000000000000C000100000000000100000C000000C000000001100000000000000001000000C000110011
1C1011000001000C010000000C000000000C00000C01001000001C00100000000000001000000001000C0000000000000000000000C00010001CC000010C00C00000C0CC0C00000000001
10000000000000010010C000000000C000100C00C010C000000000001000000000010000000000001CC00000000000000000C000000100001C0001010100C1C000000000C00C001000001
10000100C0C10000000CC0C0001C000C000000011100C10C1000000000000CC0000000000000C00010000C0C0010C000000000001CC00000000000C000000000000000000C01000C00C11
1C000000001000000000C0000C0000C0001000000000010C000000000C00C00010001000000C0010000000000CC00000000000000000000C1000000C000000000000000000000C00000C1
10000C000C00000000000000100000001000000000C0000000C0001C000001000000C0100000C000000C000000000001000C000000000CC00001000C0000100000110C010001000000001
10000000000100001000000C0010000111C00000000000000C0100000000000000010001C001010000000000C0C000000000000000000001000000C100000000001000000000000001001
100000000000000000000000000000000CC00000C00000C000000010001000000C00000C1C0C0C00000000C00001100100C0C00000010000000000100C00010000C001000000000000C01
10C000001C00000C0000000000C0010C0C0C0000000000010C0000C0000000111000C1000000C000000000000000C000001C110000C001000000000000000000010000000000CC0000001
110000000000C0000000000000100000000000100000010C00C001010C000010000000000C010C0C01C0000000000000000000000000000000C0C01000011100000110C00010C010000C1
11C0000000000110000000000C0000CC0000000CC0C00000000000000C0000000000000000C00C1000000CC00100000010000000000C0C00C00000000010000C010100000C00CC000C001
10100000000000100C100100000000000000000000000000100100C0000100100000CCC0C010000000C001000100C0000000000000C010000C00000000000000C0C000000100000100001
10000C000000000000C00000C0000000000000000000010000000000C00011010000010000000000000000C0000C00000100000C000C00C000000C00000C000C00C00C00000C0C1000001
100001C00000C000000C000000000C0100000000000000000C00C0000C00000000000000101001000000C0000000010010010000C00C00000000001000000000000001000000000000001
100CC00010000000001100000C00000C0011000000C00000000000100100000C0C00000010000C0000000000000C00C000010100000000000011C0C0C011C00C000000100000C0C000001
10C000C00000CC0C01C0000C1100000010000C0000000010000C00CCC0CC00000010CC001C00100010C1000000000C00100000000000C0000C0000C000000000C0C0010C00C00C1CC0001
10000000C000C0C001010000CC00000C0000000000C0000C000000000001000010000000000C00C0C00000010001000000000C0CC0010000000000C0100000C0000C00000000000000101
11100000000000C01000000010100C000C00100000000010001000C0CC00000C00010000C0C000000000000000000001000000C01000010000C1101100C1C0000000C0000000010C01101
1000C1001000CCC0000100000000001010CC00000000000000000C0000010001C01000000000C0000000000C0000100000000C0C00000000000000000C00000110C000C00000000C00001
101C000C00C110000CC0C0000000000000000001000000000000000010000100001000C0000000C00000000010000000C00000000C000000C0000C0C00000001C0000C10C100000010001
10000000C000000001000100C00000000C000000000C00C000C0000CC000000001C010C0000000000000001C10100C0000C0000C0000000C00000CC010CC00000000000100000010000C1
101C0000C0000100110C000100C00CC00000000001000000000C00000000000C000000C010000C0000001C00000000000C000001000000010C00000000C0100000C000C0000000C000001
100100000100C00000C11000C0000000000000000000000000010000CC0000110C000C0000CC000CC00000C000000001000000000101000000000000000010C010000000C0000000C0C01
100000000100010C0110000000001000001100C1C0C0100C0001010000C0C0000000001C00011000CC1001000001000CC000C00000010100100000000C00000C0C00C00C01000000000C1
10000000001010000000000001001000000C0C00100101000C0000000000C0100001000001000000000000C1000C000000C000C00000000000000001000000000C000C00000C00C001001
10C0C00C00C000C00000000000000010000010000000000000000000CC000000CC00000010000001000000000000001000100C0000010000C0C00100000000C000C0000C0000001001101
10100000000000000000000001C0100100000000000C0C00C10000000100000000100000000C00C1000000000010010010C00010000000C000000000C0000000100000001C01000000001
10000000000000000010100100000100000100010C0100CC000C1000000001000C0CC00100C0000000C00010010C000100C1C00011000000C0000101000000000C0000000000000010001
10000100000000C0000101C000000100C0C00C010000C0000000100001000000000010000111000101000000000000110001010000C0000000C0000000000000CC00C1010C100000010C1
1000000010001100010000001CC000000101000000C0000000010010C00C0000000010000000000C0000000000000000100C0001000010000100000000C100100000100CC010000C00001
1000001000C00001010000000000000C00001C00000000010000000001C00100000000000000000000000000C1000C000100CC00000000000CC00CC0000100000000CC0C00000000C0001
11001C000000001C00C00C10000100000C00000000C0000001000000000010100C10C0000000000001C000C0C000C000C000000C00000010100C00C0C010000001CC01C00000000000001
10C00000000000000001000000C000000C0C100C000C00000C00010000C00000000000000C00000000000000C0010001000000000010000CC00000000C101000000010000C0000C000001
10000001C000000C0000000C0000CC0C0000000C0000001000000000CC000111000C0C1000C00000000010000010C000010CC000000000011000C000000001C0010000C00100000000011
10000CC00000000000000000000C010000001100000001100010100000001100000000C000C00000000C000000100000000000000000000C00CC0C0C000C0000000000C00100000100001
100C00C000000000000001C1000001000000000C000010001C0000001C00000000000000000100000000000C0C0000000000000C00000000C0C0000000C00100011000C01000010000001
1000C00C0C100000000000000000000000100000C0000001C00000000000000001000000000000C01000000C00000000CC00001000000000000C00000C0000000C0000CC0100C10C00001
1000000001000C000C00000000C000000000000000000100000000000000000000100C0000000001000001000000C101C00000011C100110000000C01000000CC00000010000000000001
1000C1C001000CC10000C010000C00CCC0000C0000000000000000000010000000000000010000000000010000C0011101C000100000001C00100010000000C0100000001000010010001
1000000000000000000100100C0010000000C0000C00000C00001000000000000001001000100001111000C000000000C00C000000010100100000000C1C0CCC000000C1000C0000C0001
10000000110000000C00C0000C000000001000001CC000100000000000000000000001100000000000000110000000C0C000000000C00000000000010000000010C0000100000000C0001
10000000100C00000001000000C000CC000000000000101010000000000000001000C0000000000010C0000000000C0100000CC000000100000C00000C0000000000000C0CCC010000011
110001C010010C00100000000000C00000C00001000C0000000C01000000001000110000000000100000000C000000000000000C00000000C0000000000CC00C00C000C000100000C00C1
10000001000C0000000C0000C0C0C000000010000010100000CCC0000010000000000000000001000000100C0CC00C001000C00000000C10000001000010000000C000C00000000C0C001
110000010000C00000000C000000000000001000001100000000000C0001100CC00000010000000C100000000C0000000010C1C000000000C0000000000000000C0000000000000000001
1000000000000C000C00000C100001000000000C0C00100000001000C00000000000000C00000101000C1C0000C0000C00000000001000C0000C0000001C0C000010C0101000010000001
100CC00000C010000001000C0000C0000000000100000000000000010000000000C00CC00000000000000C00010000C000000011000000000000C1C00001011000100000111C001CC0001
100000000C0C000000C00000000000001000C0000000C00100C000010C0011C00010000C00001C000000000000000000001000010100000C0000000000000C0000C1000C0001000001001
10000001000000C000001000000C00000000C1C000C000000000000C0C001C0000C00001000000100001000CC0010000C000000000000000C000100C100C0CC00000001000C00110000C1
101C0C0000C0000000000000C000000C10C0000010000C00C0010000000000010000000C0010000000010C00000000C000C010010C000000100100000001000C000000001000000101001
10C01C000000000000100C0001000000100001000000C00000010000010C000001000011010000000000010010100000100000C0000000000000000000C0C00000011000000C001000011
10001000C10110CC00C000C00000C100000C0000C00C01C0000001C0000000000C000001000000000C0000000000C0011000001010000000000000C010000000C0C010011000000000C01
1000010010000001000000C000000000000C00C0010010000000000000000010000C0010100C0C001100011000C0100100000000000CC01CC0CC000000000000C001CC000000CC0000001
10000000000000000100000001000000C1000C0010000101100C0000000000100100000011100C10001C00000000000000001000010000000011C000C000000100C0C0001000000000001
1010100100C01001001000000CC0001C000000C1010CC000010000000CCC000000000000000000C00C10000000100C00C100000000011100100C001000000000C00000000C00000010001
10001C0000001000000000000C001000010010C10000100001000C000000010000C000000000000001C00CC010C000010C00000000000000CC000000000000C000C0000000C10100C1C01
10000010CC000C10C0000000000C0000001000C1CC11000000100000000000000000000C110000000000010C00000000C00100000000000000000000000000000000010100C0000011001
10C000000000000010010010CC00C1010000100000C00CC10000000C0000010C0000100C000000000101C000010100C00CC0C00000C001000C0000000000100C000C00010000000010101
100C0000000C0000000C000000C00000000000C0000000C00000100CC00000000C0000000001C001000000001110000010000C000000000C0100CC001C0C000010001000010C00C000011
1100010100C00001000C00000C00001C0C00010000000C00100000000000C0C00010C00000011000101000000C100000C000000C00000C0000000000C1000000C1100000100000000C001
100001000000000000C010000000000001000C00000000000000000000000000000001000000010000000001000000000001000000001010000C0000000C0000000CC00000000000000C1
100000C000010C0000C100000100C00C10001000000000C000000010000000C0C0000000000000010000000000C0000000000000000000C11000000000000100C10000000100001000001
100000000000C0C00C100000000001001C0000001000000000001C00000C1000C10000000C0C00C0C10010001C010000C0100010C0000000000C0C00000000C0010100000C00000000001
1000C00C00000C00000000000100C000CC10CC0000000000C0000C000000C00000000000000C00001C00000010C000C0000000C0000000000000000000C0CC000000C0000000000000001
10C0C00000000000C100000001C0001010C0000010C0000000001110C0C0000000C011000000000C0000010001000C0000001C0100000000000000C0000C0000CC01100000CC000C10001
100000000000010000C0C00000000000000001001C00010000CC011000000000001000C0001000000000000000000C0000000001000000C00C00C000001C000000C001000000000100101
10000000C000C00C1C10000001000000000CC000100000C000C00C0C000C0100000000C000000C00010C00000000000000C000000000000000C0000000000100000000000000010000011
10000C000000000000C0000000000110000C0000100001C000000000010001000000000C0000000100001000000000000000001000000C00000000C0C00000000001011000C00010001C1
100000000010000000000000000000010000000000010000C0010000C000000000000100000C0C0100100C01001000010000001C100000C000C00000100C010C000000C00000000000001
10010000000C00C0000000000010100001000010C0001000001000C00000C0000000000100000100C000C000000000C000000000000000000000000000C010000000000C0000000101001
10C000001000000000010000C0C00000000000000001000000000C000001000001000000100000C00000000000C0001C0C00001000000000011C10000C000000000000000000010C0C001
1100C0000000001C0000000000000000C00C00C10C00C000000CC0000C11C0000000000000100000010010000000010000000000000000CC0100C0C00000000000100C0C0010000000001
1001CC000010000000C001000000001000001100000000001101CC0000000C01011C000000000101C01C0000000000110000010010000C00C00C001000010000100010000000001000001
10000000C00100000C0C000010010000100000000000100000C00000000001100C00000000000C0C00000000000C00000000C10000CC000001000000010C00C000C00000000000C010001
1000100001010011000000CC000000010000000000001C010010C0000000000001000000000000000000001000000000C000000000000C000000000110000000C01C01100000C00000001
100000100C00000001000000000100000000000000C010C00C0010010C10000000000C00000000C0011000001001000000000000000000000001C0C0000000C1000000000001001000001
1C0000010000000C00000000000000000000000C000001C000CC000000000000000000000000000C000000000001000110100C00000110000000000100110100000000000000000000001
1010C001010000000000000000C0000000000010000000C000001C000000C0000C000000000C1C00CC00000001C00C00000C000C00000C100000000000000010000000000010001000001
10C10111C0000C1000100000C00C0C001000C000000100100000000001100000000001000000001000000C001000000C0000C00001000000C00000C000C010001000000000100110010C1
10C0C00011C0000000C011000000000000000C1000000C0000000000000000000100000C000C001010C1000000C0010011100000000000000000000000000C0000000C0000100C1000001
1000C00000001000C00000001010000000C0000C0000000000000000CC00100010C0000000000000000000000000000000101100110000100000010000000000000000C0000100C0100C1
1000000001C01001000000C00000000C0C001000000000001C0000000C000000000000C000000000000000000000C0000C0000000C00000C00000000001000000C0000000010C00C00011
1000100000011C10000000C000001000010000C0000000000C00C0000000000000000C0001001000000010100100000000000000000000000000000000000000C0000000001000C000001
100000000C010000000000001100001000C000100010000000C00010C00000000CC0000000000000C00000C00C00000000000000C00000000000000C000CC0000100000C01C0110C00C01
10001C00000110000001000CC00000000000000101C00CC00000000000010C100C0000000000000C000000C0000CC00110000C0000C0100000C0001000000000C000000C0100C1C000001
1010C010000000C00CC100000001000000000C0C000000000C0C0000CC0000C01100001000C10000CC00000C00000001000000000C000000000000100001C00C00C0C0000010000000001
10100C0010000C00000C00C0000100000100000C0C0000000C01000010C000011000000C000001100C000000001000010000C010001000000C0C00000000000000000100C0010C0C00101
10C00100000C10000C01001000100C00100001001000000000C0110C0C0C1C00010011C000000000000C0100000000C0C0000C00CC10000000100C0000000000C0C000000000001110001
10100000001000100000000000000C000000000C0000110CC0000C00000001001C0000000000C10CC00000000000010000C000C01010100000000010C00C0000C00010000000000000001
1C00C00000100000000C00000C0C000000000100000C000C0000000C00C00000000C010010000100000000000000000000CC0000C0C1C000001000000001C110000000C00000000000001
10001000C0000C0000C0C000001000000000000000000010C000000C010000C000001001C00000001001001000000000000001000C00000000000000000C000C01000000001000000C001
1000000C0C0000C00C0C00001010CC0C000000C00000001000000000000100101000C00C0C1C00000000000C100C10000000001000000000000000001000C000010C000C000000000CC01
100C001000000010000000000000000000CC0C00001CC000001C00000001000000000010000100000100000000000000010000000000C000010000000000000000C000000000000000C01
100000000000000000000001000C000C000C00110000C0C0000000010000001000000000001000010C000000010000C000000000100000010000000000010000000000000001001000001
1C0000000000C000C100000000001C0000010000000000000001000C00010C000000000000C00C000C10C0001000C00000000000C00001CC0100C0000000C0C000C0000000000C1C00001
11111111111111111111111111111111111111111111111111111111111111111111111111111111111111111111111111111111111111111111111111111111111111111111111111111
